11 11
+++++++++++
|         |
+++++++++ +
|       | |
+ +++++ + +
| |   | | |
+ + + + + +
| | |   | |
+ +++++++ +
|         |
+-+-+-+-+-+
