+-+-+-+-+-+-+-+-+-+-+-+-+-+-+-+-+-+-+-+-+-+
|*|***********|  ***********************| |
+*+*+-+-+-+-+*+-+*+-+-+-+-+-+-+-+-+-+-+*+ +
|*|*|   |   |*****|     |     |       |*| |
+*+*+ + + + +-+-+-+ +-+ +-+ + + +-+-+ +*+ +
|***| |   |     |   | |     |   |   | |***|
+-+-+ +-+-+-+ +-+ + + +-+-+-+-+-+-+ + +-+*+
|   |   |     |   | |   |           | |***|
+ +-+ + + +-+-+ +-+ + + +-+ +-+-+-+ + +*+-+
|   | | | |   | |   | |   |   |   | | |***|
+ + + + +-+ + + + +-+ +-+ +-+ + + + + +-+*+
| | | | |   |   |   |   |   | | |   | | |*|
+ + + + + +-+-+-+-+ +-+ +-+ + + +-+-+ + +*+
| | | |   |       |   |   |   | | |     |*|
+-+ + +-+-+ +-+-+ + + + + +-+-+ + + +-+-+*+
|   |   |   |     | | | | | |   | |   |***|
+ +-+ +-+ +-+ +-+-+-+ +-+ + + +-+ +-+ +*+-+
|     |   | | |     |   | |         | |***|
+ +-+-+ +-+ + +-+ + +-+ + +-+-+-+-+ + +-+*+
| |     |   |     |     |   |       | |***|
+ + +-+-+ + +-+-+-+-+-+-+-+ +-+-+-+-+ +*+-+
| | |     |         |     | |         |*| |
+-+ + +-+-+-+-+-+-+ +-+ + + + +-+-+-+-+*+ +
|   | |   |       |   | |   | |*********| |
+ +-+ + +-+ + +-+ +-+ + + +-+ +*+-+-+-+-+ +
| |   |     | |     |   | |   |***|  *****|
+ +-+ + +-+-+ +-+-+-+-+-+ + +-+-+*+-+*+-+*+
|   | | |   |           | |   | |***|*| |*|
+-+ + +-+ + +-+-+ + +-+-+ +-+ + +-+*+*+ +*+
|   | |   |     | |         |   |***|*|***|
+ +-+ + +-+-+-+ + +-+-+-+-+-+-+ +*+-+*+*+-+
| |         |   | |       |     |*****|***|
+ +-+-+-+-+ + +-+-+ +-+-+ + +-+-+-+-+-+-+*+
| |   |   | |     |   | |   |*******  |***|
+ + + + + + +-+-+ +-+ + +-+-+*+-+-+*+-+*+-+
|   | | | |   |     | |   |***|***|*****| |
+ +-+ + + +-+-+ +-+-+ + + +*+-+*+*+-+-+-+ +
| |   | |     |         | |*****|*|*****| |
+-+ + + +-+-+ + +-+-+-+-+ +-+-+-+*+*+-+*+ +
|   | | | |   | |   |         |***|*| |***|
+ +-+-+ + + +-+-+ + +-+-+-+-+-+*+-+*+ +-+*+
|         |       |            *****|    *|
+-+-+-+-+-+-+-+-+-+-+-+-+-+-+-+-+-+-+-+-+-+
