7 9
+-+-+-+-+
|       |
+ +-+-+ +
|     | |
+ +-+ +-+
| |     |
+-+-+-+-+
