43 43
+++++++++++++++++++++++++++++++++++++++++++
| |           |                         | |
+ + +++++++++ +++ +++++++++++++++++++++ + +
| | |   |   |     |     |     |       | | |
+ + + + + + +++++++ +++ +++ + + +++++ + + +
|   | |   |     |   | |     |   |   | |   |
+++++ +++++++ +++ + + +++++++++++++ + +++ +
|   |   |     |   | |   |           | |   |
+ +++ + + +++++ +++ + + +++ +++++++ + + +++
|   | | | |   | |   | |   |   |   | | |   |
+ + + + +++ + + + +++ +++ +++ + + + + +++ +
| | | | |   |   |   |   |   | | |   | | | |
+ + + + + +++++++++ +++ +++ + + +++++ + + +
| | | |   |       |   |   |   | | |     | |
+++ + +++++ +++++ + + + + +++++ + + +++++ +
|   |   |   |     | | | | | |   | |   |   |
+ +++ +++ +++ +++++++ +++ + + +++ +++ + +++
|     |   | | |     |   | |         | |   |
+ +++++ +++ + +++ + +++ + +++++++++ + +++ +
| |     |   |     |     |   |       | |   |
+ + +++++ + +++++++++++++++ +++++++++ + +++
| | |     |         |     | |         | | |
+++ + +++++++++++++ +++ + + + +++++++++ + +
|   | |   |       |   | |   | |         | |
+ +++ + +++ + +++ +++ + + +++ + +++++++++ +
| |   |     | |     |   | |   |   |       |
+ +++ + +++++ +++++++++++ + +++++ +++ +++ +
|   | | |   |           | |   | |   | | | |
+++ + +++ + +++++ + +++++ +++ + +++ + + + +
|   | |   |     | |         |   |   | |   |
+ +++ + +++++++ + +++++++++++++ + +++ + +++
| |         |   | |       |     |     |   |
+ +++++++++ + +++++ +++++ + +++++++++++++ +
| |   |   | |     |   | |   |         |   |
+ + + + + + +++++ +++ + +++++ +++++ +++ +++
|   | | | |   |     | |   |   |   |     | |
+ +++ + + +++++ +++++ + + + +++ + +++++++ +
| |   | |     |         | |     | |     | |
+++ + + +++++ + +++++++++ +++++++ + +++ + +
|   | | | |   | |   |         |   | | |   |
+ +++++ + + +++++ + +++++++++++ +++ + +++ +
|         |       |                 |     |
+-+-+-+-+-+-+-+-+-+-+-+-+-+-+-+-+-+-+-+-+-+
