23 23
+++++++++++++++++++++++
|                 |   |
+++++++++++++++++ + + +
|   |       |     | | |
+ + + + +++++ +++++ + +
| | | |     | |     | |
+ + + +++++ + + +++++ +
| | |   | |   |   | | |
+ + +++ + +++++++ + + +
| |   | |       | |   |
+ +++ + +++ +++ + + +++
| | | |   | | |   |   |
+ + + +++ + + +++++++ +
| | | | | | |       | |
+ + + + + + + +++++ + +
| |     |   | |   | | |
+ + +++++++++ + + + + +
| | |         | | | | |
+ +++ +++ +++++ +++ + +
| |   |   |         | |
+ + +++ +++++++++++++ +
|     |               |
+-+-+-+-+-+-+-+-+-+-+-+
