+-+-+-+-+-+-+-+-+-+-+-+
|*****************|***|
+-+-+-+-+-+-+-+-+*+*+*+
|   |***    |*****|*|*|
+ + +*+*+-+-+*+-+-+*+*+
| | |*|*****|*|*****|*|
+ + +*+-+-+*+*+*+-+-+*+
| | |***| |***|***| |*|
+ + +-+*+ +-+-+-+*+ +*+
| |   |*|  *****|*|***|
+ +-+ +*+-+*+-+*+*+*+-+
| | | |***|*| |***|***|
+ + + +-+*+*+ +-+-+-+*+
| | | | |*|*|       |*|
+ + + + +*+*+ +-+-+ +*+
| |     |***| |   | |*|
+ + +-+-+-+-+ + + + +*+
| | |         | | | |*|
+ +-+ +-+ +-+-+ +-+ +*+
| |   |   |         |*|
+ + +-+ +-+-+-+-+-+-+*+
|     |              *|
+-+-+-+-+-+-+-+-+-+-+-+
