+-+-+-+-+-+
|*********|
+-+-+-+-+*+
|       |*|
+ +-+-+ +*+
| |   | |*|
+ + + + +*+
| | |   |*|
+ +-+-+-+*+
|        *|
+-+-+-+-+-+
