+-+-+-+-+
|*      |
+*+-+-+ +
|*****| |
+ +-+*+-+
| |  ***|
+-+-+-+-+
